11111111111111111111
1E010100100110111011
100111010101C01C1111
10010111110100100011
1P010110001000000111
10000000000000000001
10000000000000000001
11100001110C11001011
10010001001100101111
111C0001001111100C11
10010101110100100111
11111111111111111111